SO textures/wolfenstein/purple_stone.xpm
NO textures/wolfenstein/grey_stone.xpm
WE textures/wolfenstein/red_brick.xpm
                     EA                                      textures/wolfenstein/wood.xpm

F 0,                                      0,          0
C          225, 30,0

                1111111111111111111111111 
        1111111111000000000110001111111111
        1011000001110000000000001         
        1001000000000000000000001         
111111111011000001110000000000001         
100000000011000001110111111111111         
11110111111111111100000010001             
111101          100W000000001111          
11000111111111111000000100011             
10000000000000001100000010001             
10000000000000001101010010001             
1100000111010101111101111000111           
11110111 1110101 101111010001             
11111111 1111111 111111111111             
