NO textures/NO.xpm
SO textures/SO.xpm
WE textures/WE.xpm
EA textures/EA.xpm

F 164,169,20
C 153,204,255

111111
100001
1N0001
111111
