NO textures/NO.xpm
SO textures/SO.xpm
WE textures/WE.xpm
EA textures/EA.xpm

F 20,20,20
C 200,200,200

11111
10001
10S01
10001
10111
101
10111
10001
10001
10001
10001
10001
11111
