NO textures/NO.xpm
SO textures/SO.xpm
WE textures/WE.xpm
EA textures/EA.xpm

F 164,169,20
C 153,204,255

111111111111111111111
101000000100000000001
101010101011111110001
1000101000S0000010001
111110101100101011101
100000101 10101000001
101111101 11101111111
101000001 10100000101
101011111 10111110101
101010001 10100010101
101110101 10101010101
100000101 10001010001
111111101111111011101
100000101000100010001
101110101110101110111
101000100000100010101
101011111111111010101
100010000000000010001
101010111011111111101
101000001000000000001
111111111111111111111