NO /home/mgimon/Cub3d/textures/wet_sponge.xpm
SO /home/mgimon/Cub3d/textures/wet_sponge.xpm
WE /home/mgimon/Cub3d/textures/wet_sponge.xpm
EA /home/mgimon/Cub3d/textures/wet_sponge.xpm

C 53,41,34
F 45,33,27

1111111
10N0001
1011001
1000001
1N00001
1111111